XXXXXXX
X00000X
X01000X
X11110X
X01111X
XXXXXXX
