XXXXXX
X0010X
X1010X
X0010X
X1110X
XXXXXX
