XXXXXX
X0001X
X0000X
X0100X
X1100X
X1001X
X1000X
X1000X
X1101X
X0110X
XXXXXX
