XXXXX
X011X
X000X
X100X
X000X
X111X
X001X
XXXXX
