XXXXXXXX
X000110X
X001110X
X100000X
X010100X
X110010X
XXXXXXXX
