XXXXXXXXX
X1100010X
X0000010X
X0101000X
XXXXXXXXX
