XXXXXXXX
X000001X
X101111X
X100110X
X101110X
X101011X
X001011X
XXXXXXXX
