XXXXXXX
X00010X
X10010X
X10000X
X11001X
X01001X
XXXXXXX
