XXXXXXXXXX
X00001001X
X11100100X
X01010100X
X11100110X
X00010010X
XXXXXXXXXX
