XXXXXXX
X10001X
X00000X
X10100X
X00010X
X00010X
X10101X
X10000X
X11001X
X11110X
XXXXXXX
