XXXXXXX
X00001X
X01100X
X01011X
X10010X
X01011X
X10001X
XXXXXXX
