XXXXXXXXXX
X11110001X
X01010010X
X10100110X
X00001011X
X00001011X
X00110111X
X11001101X
X01000001X
X01011000X
XXXXXXXXXX
