XXXXX
X010X
X111X
X010X
XXXXX
