XXXXX
X101X
X010X
X000X
X111X
X011X
X100X
X001X
XXXXX
