XXXXXXXX
X010100X
X010110X
X011000X
XXXXXXXX
