XXXXX
X000X
X010X
X000X
XXXXX
