XXXXX
X110X
X011X
X100X
XXXXX
